Before the World Ends
En Garde
0000000000000000000000000000000000000000000000000000000000000000000000000020000000000001242000000000111120000000001100020000000021200200000022221112220000200100002000002012125020000011015202200000001100502000000021100200000000010111000000003100100000000000150000000000000000000000000000000000000000000000000000000000000000
Frenzy
0000000000000000000000000000000000000000000000000000000000000000000000000000000000000000000000000000000000000000000051000000000000100000000000051011110000000013224100000000511011000000000100000000000005000000000000000000000000000000000000000000000000000000000000000000000000000000000000000000000000000000000000000000000000
Machiavelli
0220000000002225200000000252022222212222220212001100222000212021202120002201021212000022020020220001002222200100022210200120202020222120202010012100211201210213041202200010210021120000212200222000000010200210000002020002000000021025011000002010002020000020022220100001001010120000005112212100000000000000000000000000000000
Morgenland
0000000000000000000000000000000000000000000000000000000000000000000000000000020000000000002512000000002100020000000022212120000000102212000000022101020000002503040120000002120021000000002122020000000000022210000000002522000000000002200000000000000000000000000000000000000000000000000000000000000000000000000000000000000000
Sinistra
0000000000000000000000000000000000000000000000000000000000000050000000000001100000000000010100000000001001000000000010401000000002022020000000021202220000002022012200000002121221000000020202020000000202212200000002202052000000005252220000000222250000000000000000000000000000000000000000000000000000000000000000000000000000
Sound of Silence
0000000000000000000000000000000100000210010215100022101002001211122251210020002002100122202002002212211120100010112200021102011021200201102022221112220202110200042010202212120020010112020202011010102200032102011222102121201001112111222112020120222010000101122220020022011000111200152022000005102112000000011000000000000000